NO ./textures/SUPPORT_4A.xpm
SO ./textures/TECH_2F.xpm
WE ./textures/TECH_1E.xpm
EA ./textures/TECH_4F.xpm

F 220,100,0
C 225,30,0

        1111111111111111111111111
        100000000011000000000A001
        1011000001110000000000001
        1001000000B00000000000001
111111111011000001110000000000001
100000000011000001110111111111111
11110111111111011100000010001
11110111111111011101010010001
11000000110101011100000010001
10000000000000001100000010001
10000000000000001101010010001
11000001110101011111011110N0111
11110111 1110101 101111010001
11111111 1111111 111111111111
