NO ./textures/SUPPORT_4A.xpm
SO ./textures/TECH_2F.xpm
WE ./textures/TECH_1E.xpm
EA ./textures/TECH_4F.xpm
F 42,52,57
C 33,33,33

111111111111111111111
111111111100000100011
101010101011111110001
100010100010000010001
101110101111101011101
100000101000101000001
101111101011101111111
101000001010100000101
1C1011111010111110101
101010001010100010101
101111101010101010101
1KD000101010001010001
101111101011111011101
101000101000100010001
101111101110101110111
101000100000100010101
101011111111111010101
100000001000000010001
101000111011111111101
1N1000001000000000001
111111111111111111111
